##########
#S  ######
#  #######
#   ######
##  # G###
##     ###
##########
